f999100 f999000 r600000
f999200 f999100 r600100
a999300 f999200 r200200
a999400 f999300 h400300
a999500 f999400 r400400
a999100 f999500 r400500
a999200 f999000 r400500 
a999300 f999100 r700500
a999400 f999200 r400300
a999500 f999300 r800500
a999100 f999400 r200200
a999200 f999500 r100300
