a999000 a999100 a999200 c999300 a999400 c999500
a999000 a999100 d999200 a999300 a999400 c999500
a999000 d999100 c999200 d999300 a999400 a999500
a999000 a999100 d999200 a999300 a999400 c999500
a999000 d999100 c999200 d999300 a999400 a999500
a999000 a999100 a999200 c999300 a999400 c999500
a999000 d999100 c999200 d999300 a999400 a999500

